00000001
00010001
01111001
01211101
01221001
01222111
01221101
00121001
00111101
00000001