11111000
12221100
12221100
12222110
11222110
11122100
11122000
12222100
12222100
12222110
11222110
01222110