11111000
12221100
12221100
12222110
11222110
11122100
11122000
12332100
12332100
12332110
11332110
00332110